#########S#
#         #
# #####   #
# #   #   #
# # ### # #
# # #   # #
#   # # # #
### # # # #
#   #     #
# # # # # #
#     #   #
#####E#####
